......h.....
........<r>.
......hhwdw.
.H..........
........R...
............
............
..R.........
.......H....
............